@.......#
#######.#
#.......#
#.#######
#.#######
#.......#
#######.#
#.#####.#
#.#.....#
#.#.#####
#.#.....#
#.#####.#
#.#.....#
#.#.#####
#.......#
#.#####.#
#.......#
#.#######
#.#######
#........
########F